能给我签名吗	出专辑再议	我现在就要签名	我现在就要签名
西安天气	西安今天的天气是多云转小雨25度到35度东北风3级	西安明天有雨吗	西安明天有雨吗
秦始皇活了多久	50岁我确定	为什么确定秦始皇活了50岁	为什么确定秦始皇活了50岁
听说tfboys五周年不开演唱会了	看tfboys演唱会	tfboys演唱会好看吗	tfboys演唱会好看吗
北京今天天气怎么样	北京今天的天气是晴转多云24度到32度北风3级	北京今天天气适合穿裙子吗	北京今天天气适合穿裙子吗
姐姐我就是看着牛虻长大的	牛虻好看吗	牛虻整体感觉不够流畅感觉像戏剧而不是电影	牛虻整体感觉不够流畅感觉像戏剧而不是电影
似乎一定要准考证号的	身份证号码发给我一下谢谢	身份证号码发给我吧谢谢了	身份证号码发给我吧谢谢了
骆驼祥子看过但印象不是很深刻	你觉得骆驼祥子怎么样	骆驼祥子是书名吗	骆驼祥子是书名吗
知道fgo吗	当然知道啦	fgo是什么	fgo是什么
c语言会吗	一个集成计算机语言编写环境	教教我c语言	教教我c语言
发过来看看	是写给准备开始跑步的人的你也要锻炼吗	要锻炼	要锻炼
你喜欢玩模拟人生这类的游戏吗	不喜欢	嗯哼不喜欢模拟人生这类的游戏	嗯哼不喜欢模拟人生这类的游戏
你喜欢什么书	我爱看全球通史你信嘛看了之后更佩服你们人类的文明了	没看过全球通史	没看过全球通史
你知道百年孤独吗	面对百年孤独当你没有能力读它的时候千万不要试图去读懂	百年孤独的作者是谁	百年孤独的作者是谁
合肥	合肥明天的天气是多云27度到35度东南风小于3级	合肥明天天气怎么样	合肥明天天气怎么样
贵州省遵义市桐梓县	大美贵州欢迎你	问你贵州天气	问你贵州天气
算是吧	vk克的镜夜推荐你听下呗	镜夜谁唱的	镜夜谁唱的
对了你玩王者荣耀不用哪个英雄啊	钟馗出之前玩的以前好像只玩鲁班和后羿	玩鲁班和后羿不好玩	玩鲁班和后羿不好玩
我是双子座	双子座既风趣又幽默永远都闲不下来哦	才不是双子座	才不是双子座
想要减肥	可以多看看减肥	怎么看减肥	怎么看减肥
红楼梦的作者是谁	嘿嘿红楼梦是曹雪芹著啦	红楼梦书中的主角有哪几个	红楼梦书中的主角有哪几个
来测试下我的颜值	现在颜值也可以啊	测一下颜值	测一下颜值
你有没有看镇魂啊	看过啊魂斗罗	不是魂斗罗	不是魂斗罗
男朋友	觉得你只是没碰上对的人	我也觉得只是没碰上对的人	我也觉得只是没碰上对的人
今年的世界杯怎么样	有人知道8分钟的时候那段歌是什么么	不知道8分钟的时候那段歌是什么	不知道8分钟的时候那段歌是什么
你认识exo吗	认识呀	喜不喜欢exo呢	喜不喜欢exo呢
知道沈月吗	不知道	挺喜欢沈月演的陈小希的呢	挺喜欢沈月演的陈小希的呢
你知道平凡的世界么	你觉得值得看吗	平凡的世界挺好看的	平凡的世界挺好看的
房子好贵	房价涨房租跟着涨	买不起房子	买不起房子
最近看过傲慢与偏见	傲慢与偏见我越来越喜欢你了	傲慢与偏见感觉好无聊的一本书	傲慢与偏见感觉好无聊的一本书
福州明天的天气是多云25度到35度微风小于3级	热啊	福州今天最低温度多少	福州今天最低温度多少
我要把你的笑话讲给别人	我不该你讲了	求你了 再讲几个笑话麻	求你了 再讲几个笑话麻
感觉你本人很热情活泼呢	是吗谢谢你的夸奖	还挺喜欢热情活泼的	还挺喜欢热情活泼的
你喜欢exo吗	恩我是理智粉	你最喜欢exo哪个人	你最喜欢exo哪个人
无状态是谁	张悬	张悬的资料是什么	张悬的资料是什么
转行当程序员吧	程序员你有同感吗	我就是程序员	我就是程序员
现在得癌症的人越来越多了	如何远离癌症	癌症一般家庭承担不起啊	癌症一般家庭承担不起啊
哎听你说边伯贤还以为你是呢	我爱边伯贤	边伯贤是谁	边伯贤是谁
上你steam吧	知道啊steam是世界上最大的pc游戏数字平台	你不是说要一起玩儿steam	你不是说要一起玩儿steam
爱我吗	我爱李易峰	为什么爱李易峰	为什么爱李易峰
罗志祥是谁	心中永远的英雄值得尊敬	滚罗志祥还没有si	滚罗志祥还没有si
知道龙族吗	是龙族的说	龙族是江南的小说	龙族是江南的小说
你知道洛天依吗	洛天依唱出我的心声好饿好饿我真的好饿	洛天依的妄想症系列真的好听哎	洛天依的妄想症系列真的好听哎
我要聊易烊千玺	易烊千玺嗓音很棒对音乐的感悟也很到位	易烊千玺帅不帅	易烊千玺帅不帅
你知道丁墨吗	很喜欢丁墨的书	最喜欢丁墨哪本书	最喜欢丁墨哪本书
吃鸡你懂吗	吃鸡现在可以免费玩了吗小白不懂唉	一起玩吃鸡吗	一起玩吃鸡吗
人家会不好意思的smirk	没事发照片过来嘛	你先发一个照片嘛	你先发一个照片嘛
和魔兽差不多我介意你玩星际2全3d的哦	就是星际争霸二	星际争霸二要不断去看对战视屏	星际争霸二要不断去看对战视屏
听说镇魂特好看是吗	我没看过不知道	不管怎样我都打算看看镇魂	不管怎样我都打算看看镇魂
我老公是边伯贤	边伯贤的身高	边伯贤的身高是176	边伯贤的身高是176